# map : def
# RoboMind Map Definition
# Generated with RoboMind Version 6.0.1
# Copyright © 2005 - 2016
# http://www.robomind.net

extra:

paint:

map:
CHHHHHHHHHHHHHHHHHHHHHHHHHHD
GMFFFFFFFFFFFFFFFFFFFFFFFFJI
GI                        GI
GI                        GI
GI                        GI
GI                        GI
GI                        GI
GI                        GI
GI                        GI
GI                        GI
GI                        GI
GI                        GI
GI                        GI
GI                        GI
GI                        GI
GI                        GI
GI                        GI
GI@                       GI
GLHHHHHHHHHHHHHHHHHHHHHHHHKI
BFFFFFFFFFFFFFFFFFFFFFFFFFFE
