# This file was saved at Tue Mar 26 2019 22:09:48 GMT-0300 (Horário Padrão de Brasília)
# from https://robomindmap.rix0r.nl/

extra:
palm@30,0
palm@0,5
palm@23,6
palm@23,7
palm@23,8
palm@0,10

paint:

map:
CHHHHHHHHHHHHHHHHHHHHHHHHHHHHHHHHD
G* OO O      QOOOOOOOOO*OOO   O *I
GO OO O  OOO         OO     O O  I
GR    OO   O  OOOO O OOOOOOOO OO I
GROOO  O   O       O             I
GR     O O O O  PP O   OROOOO OO I
GR   O   O * O OOOOO Q PRP    OO I
GO O O     OOO    PP Q P P    OO I
GO O O  OO   O QQ      P P OO  O I
GO O       O O     O   RRO  OO   I
GR OOOOO   O   PP OO OORRO       I
GR     O   OOOOOO OO        O OO I
GO OOO O   O      OO Q O  O O  O I
GR OOO O   O OOOO  O   OOOO    O I
GR@O Q   O   *OO     O      O   *I
BFFFFFFFFFFFFFFFFFFFFFFFFFFFFFFFFE